11111111111111111111111111
1C0E0000000000000000C00001
1C000000000000000000000001
111101010010000010100100C1
10000000000000000000000001
100C000P0000C000000000N001
100C00000000C00001C00C0001
11111111111111111111111111