11111111
100001P1
1C00N011
1C000001
11111111