1111111111111
1000000000001
1C0P000000001
1111111111111