111111
1001P1
100C11
1E0001
111111