11111111
100000P1
10000C01
11111111